edad;educ;mashi;noant;ant;tot
22.5;nop;Si;53;6;59
22.5;nop;No;10;4;14
22.5;pro;Si;212;52;264
22.5;pro;No;50;10;60
27.5;nop;Si;60;14;74
27.5;No;No;19;10;29
27.5;pro;Si;155;54;209
27.5;pro;No;65;27;92
35;nop;Si;112;33;145
35;nop;No;77;80;157
35;pro;Si;118;46;164
35;pro;No;68;78;146
45;nop;Si;35;6;41
45;nop;No;46;48;94
45;pro;Si;8;8;16
45;pro;No;12;31;43
